111111111
100000C01
10P001111
10C001E01
100001001
111111111